29,22 28,21 27,20 26,19 25,18 24,17 23,16 22,15 21,14 20,14 19,15 18,16 17,17 16,18 15,19 14,20 13,21 12,22
5,21 4,20 3,19 2,18 1,17 0,16 0,15 0,14 0,13 0,12 0,11 0,10 0,9 0,8 0,7 0,6 1,5 2,4 2,3 3,2
17,29 18,28 19,27 20,26
25,9 24,9 23,10 22,10 21,10 20,10 19,11 18,12 17,13 16,14 15,15 14,16 13,17 12,18 11,19 10,20
29,23 28,22 27,21 26,20 25,19 24,18 23,17 23,16 22,15 21,14 20,13 19,12 18,11 17,10 16,9 17,8
11,29 10,28 9,27 8,26 7,25 6,24 7,23 8,22 9,21 10,20 11,19 12,18 13,17 12,16 12,15 13,14 14,13 15,12
6,1 5,2 4,3 3,4 2,5 1,6 0,7 0,8 0,9 0,10 0,11 0,12 0,13 0,14 1,15 2,16 3,17 4,18 5,19 6,20 7,21 8,22 9,23 10,24 11,25
1,0 2,0 3,0 4,0 5,0 6,0 7,0 8,1 9,2 10,3 11,4 12,5 11,6 10,7 9,8 8,9 8,10 9,11 10,12 11,13 12,14 13,15 14,16 15,17 16,18 17,19 18,20
5,27 6,26 7,25 8,24 9,23 10,22 11,21 12,20 13,19 14,18 15,17 16,16 17,15 18,14 19,13 20,14 21,15
0,10 0,9 0,8 0,7 1,6 2,5 3,4 4,3 5,2 6,1 7,0 8,0 9,1