60,109 60,108 61,107 62,106 63,105 63,104 63,103 63,102 62,101 62,100 63,99 64,98 65,97 66,96 67,95 68,94 69,93 70,92 71,91 72,90 73,89 74,88 75,89 76,89 77,89 78,88 79,87 80,86 81,85 82,84 83,83 84,82 85,81 86,82 87,83 88,84 89,85
48,15 47,14 46,13 45,12 44,12 43,13 42,14 41,15 40,16 39,17 38,18 37,19 36,20 35,21 34,22 33,22 32,22 31,22 30,21 29,21 28,22 27,23 26,24 25,25 24,26 23,27 22,28
51,17 50,18 49,19 48,20 47,21 46,22 47,23 48,24 48,25
245,249 244,248 243,247 242,246 241,246 240,247 239,248 238,249 237,249 236,249 235,248 234,248
152,112 151,111 150,110 149,109 148,108 147,107 146,106 145,105 144,104 143,103 142,102 141,101 140,100 139,99 138,99 137,98 136,97 135,96 134,95 133,94 132,93 131,92 131,91 130,90 131,89 132,88 133,87 134,86 135,85 136,84 137,83
66,70 65,69 64,68 63,67 62,66 61,65 60,64 59,63 58,62 57,62 56,63 55,64 54,65
0,86 0,87 0,88 1,89 2,88 3,87 4,88 5,89 6,89 7,89
180,190 180,191 181,192 182,193 183,193 184,194 185,195 186,196 187,197 188,198 189,199 190,200 191,201 192,202 192,203 192,204 191,205 190,206 189,207 188,208 187,209 186,210 185,211 184,212 183,213 182,214 182,215 183,216 184,217 185,218 186,219
124,0 125,0 126,0 127,0 128,0 129,0 130,0 131,1 132,2 133,3 134,4 135,5 136,6 137,7 138,8 139,9 140,10 139,11 138,12 138,13 139,14 140,15 141,16 142,17
18,85 17,84 17,83 18,82 19,81 20,80 21,79 22,78
126,6 125,7 124,8 123,9 124,10 125,11 126,12 127,13 128,14 129,15 130,16 131,17 132,18 133,19 134,20 135,21 136,22 137,23 138,24 139,25 139,26 139,27 140,28
59,177 58,176 57,175 56,174 55,173 54,172 53,171 52,170 51,169 50,168 49,167 48,166 47,165 46,164 45,164 44,164 43,163 42,162 41,161 40,160 39,159 38,158 37,158 36,159 35,160
0,35 1,34 2,33 3,32 4,31 5,32 6,33 7,33 8,33 9,32 10,31 11,30 12,29 13,28 14,27 15,26 16,25 17,25 18,24 19,23 20,22 21,23 22,24 23,25 24,26 25,27 26,28 27,29
150,215 149,216 148,217 147,218 146,219 145,220 145,221 146,222 147,223 148,224 149,225 150,226 151,227 152,228 153,229 154,230 155,231 156,232 156,233 156,234 155,235
216,109 215,110 214,111 213,112 212,113 211,114 212,115 213,116 214,117 215,118
128,13 128,14 129,15 130,16 131,17 132,18 133,19 134,20 134,21 135,22 136,23
102,205 102,204 101,203 100,202 100,201 99,200 99,199 99,198 99,197 98,196 97,195 97,194 96,193 95,192 94,191 93,190 93,189 92,188 93,187
34,18 35,17 36,16 37,15 38,16 39,15 40,14 41,13 42,12 43,11 44,10 45,9 46,9 47,10 48,11 49,12 50,13 51,14 52,15
148,249 147,248 146,247 145,246 144,245 143,244 142,243 142,242 143,241 143,240 144,239 145,238 146,237 147,236 148,235 148,234 148,233 147,232 147,231 147,230 148,229 149,228 150,227 151,226 152,225 153,224
138,80 137,79 137,78 136,77 135,76 135,75 136,74 137,73 138,72 139,71
130,78 131,77 132,76 133,75 134,74 135,73 136,72 137,73 138,74 139,74 140,75 141,76 142,77 143,78 144,79 145,80 146,81 147,81
5,244 4,243 3,242 3,241 4,240 5,239 5,238 4,237 4,236 4,235 4,234 4,233 3,232 4,231 5,230 6,229 7,228 8,227 9,226 10,225
8,244 9,244 10,244 11,243 12,242 13,241 14,240 15,239 16,238 17,237 18,236 19,235 20,234 21,233 22,233 23,233 24,234 25,235 26,236 27,237 28,238 29,239
23,121 22,120 21,119 20,118 19,118 18,117 17,117 16,116 15,116 14,115 13,114 12,113 11,112 10,111 9,110 8,109 8,108 7,107 6,106 5,105 4,104 3,104 2,104 1,104 0,103 0,102 0,101 0,100
67,37 66,38 65,39 66,40 67,41 67,42 67,43 67,44 68,45 69,46 70,47 71,48 70,49 69,50 68,51 67,52 66,53 65,54 65,55 66,56 67,57 68,58 69,59 70,60 70,61 70,62 71,63 72,64
210,12 209,11 208,10 207,10 206,11 205,12 204,13 203,14 202,14 201,14 200,15 199,16
41,47 40,48 39,49 38,50 37,51 36,52 35,53 35,54 34,55 33,56 34,57 35,58 36,59 37,60 38,61 39,62 40,63 41,64 42,65 43,66 44,67 45,68 46,69 47,70 48,70 49,70 50,69 51,70 52,71 53,72 54,73 55,74 56,75 57,75 58,76
203,190 202,189 201,188 200,187 201,186 202,185 203,184 204,183 205,182 206,181 207,180 208,179 209,178 210,177 211,176 212,175 213,174 214,174 215,174 216,173 216,172 216,171 216,170 215,169 214,168 213,167 212,166 211,165 212,164
114,84 113,83 112,82 111,81 110,80 109,79 108,78 107,77 106,76 105,75 105,74 105,73 104,72 103,71 102,70 102,69 101,68 100,67 99,66 98,65 97,64 96,63 95,62 94,61 94,60
204,116 203,117 202,118 201,119 200,120 200,121 199,122 198,123 197,124 197,125 198,126 199,127 200,128 200,129 201,130 202,131
123,240 122,239 121,238 120,237 121,236 122,235 123,234 124,233 125,232 126,231 127,230 128,229 129,228 130,227 131,226 132,225 133,224 134,223 135,222 136,221 136,220 135,219 134,218 133,217 132,216 131,216 130,215 129,214 128,213 127,214 126,215
178,167 177,166 176,165 175,164 174,163 173,162 172,161 171,160 170,159 169,158 168,157 168,156 167,155 166,154 165,153 164,152 164,151 163,150 163,149 164,148 163,147 163,146 162,145 162,144 162,143 161,142 160,141 159,140 158,139 157,138 156,137 155,136 154,136 153,137
191,111 190,110 190,109 191,108 191,107 191,106 192,105 193,104 194,103 195,102 196,101 197,100 198,99 199,98 200,97 201,96 202,95 203,94 204,93 205,92 206,91 207,90 208,89 209,88 210,87 211,87 212,88
246,139 246,140 246,141 246,142 246,143 246,144 246,145 246,146 246,147 246,148 246,149 245,150 244,151 243,151 242,151 241,150 240,149 239,148 238,147 237,146 236,145 235,144 234,143 233,144 232,143 231,143 230,144 229,145 228,146 227,147 226,148 225,149 224,150 223,151 222,152 221,153 220,154 219,155 218,156 217,156
124,41 125,40 126,39 127,38 128,37 129,38 130,39 131,40 132,41 133,42 134,43 135,44 136,45 137,46 138,47 139,47 140,48 141,49 142,50 143,51 144,52
76,99 76,98 75,97 74,96 74,95 74,94 73,93 72,92 71,91 70,90 69,89 68,88 67,87 66,86 65,87 64,88 63,89
143,228 142,227 141,226 140,225 139,224 138,223 137,222 136,221 136,220 135,219 134,218 133,217 132,216 131,216 130,215 129,214 128,213 127,212 126,211 125,210 124,209 123,208 122,207 121,207 120,208 119,209 118,210
154,141 153,140 152,139 151,138 150,137 149,136 148,135 147,134 146,133 145,132 144,133 143,134 142,134 141,134 140,133 139,132 138,131 137,130 136,129 135,128 134,127 133,126 132,125 131,124 130,123 129,122 128,121 128,120 127,119 127,118
62,78 61,77 62,76 61,75 60,74 59,73 58,72 57,71 56,70 55,69 54,68 53,67 54,66 55,65 56,64 57,63 58,62 59,61 60,60 60,59 60,58 60,57 59,56 58,55 57,54 57,53 56,52 55,51 54,50 54,49
155,70 156,69 157,68 158,67 159,66 160,65 161,64 162,63 163,62 164,62 165,61 166,60 167,60 168,61 169,62 170,63 171,64 172,65 173,66 174,67 175,68 176,69 177,70 178,70 179,70 180,69 181,68 182,69
200,188 199,187 198,186 197,187 196,188 195,189 194,190 193,191
246,0 247,0 248,0 249,1 249,2 249,3 248,4 247,5 246,6 245,7 244,8 243,9 243,10 244,11 245,12 245,13 245,14 245,15 246,16 247,17 248,18 249,19 249,20 249,21 249,22 248,23 248,24 248,25 248,26
50,23 51,24 52,25 53,26 54,27 55,28 56,29 57,30 58,31 59,32 60,33 61,34 62,35 63,36 64,35 65,36 66,37 67,38 68,39 69,39 70,40 71,41 72,40 73,40 74,41 75,42 76,42
114,206 113,205 112,204 111,203 110,202 111,201 111,200 110,199 111,198 111,197 112,196 113,195 114,194 115,193 116,192 117,191 118,190 119,189 120,188 121,187 121,186 122,185 123,184 124,183 125,182
173,210 174,209 175,208 176,208 177,207 178,206 179,205 180,204 181,204 182,205 183,206 184,207 185,208 186,209 187,209 188,209 189,210 190,211 191,212 192,213 193,214
205,29 204,28 203,27 202,26 201,25 200,24 199,23 198,22 197,22 196,22 195,21 194,20 193,20 192,21
151,69 150,68 149,67 148,66 147,65 146,65 145,66 144,67 143,66 142,65 141,64 140,63 139,62 138,61 137,60 136,59 135,58 134,57 133,56 132,55 131,54 130,53 129,52 128,51 127,52 126,51 125,50 125,49 124,48 123,47 122,46 121,45 120,44 121,43
167,201 166,200 165,199 164,198 163,197 162,196 161,195 160,194 159,193 158,192 157,191 156,190 155,189 154,188 153,187 152,186 151,185 150,184 149,183 148,182 147,183 146,184 145,185 144,186 143,186
182,145 181,144 180,143 179,143 178,142 177,141 176,140 175,139 174,138 173,137 172,136 172,135 173,134 173,133 173,132 172,131 171,130 170,129 169,128 168,127 167,126 166,125 165,124 164,124 163,124 162,124 161,123 160,123 159,122 158,121 159,120 160,119 161,118 162,117 163,116 164,115
135,130 134,130 133,129 132,128 131,127 130,127 129,128 128,129 127,130 126,130 125,131 124,132 123,133 122,134 121,135 120,136 119,137 118,136 117,136 116,135 115,134 114,133 113,132 112,133 111,134 110,135 109,136 108,137 107,138
148,218 147,217 146,216 145,215 144,214 143,213 142,212 141,211 140,210 139,209 138,208 137,207 136,206 135,205 134,204 134,203 135,202 136,201 136,200 135,199 134,198 134,197 134,196 134,195 135,194 135,193 134,192 133,191 132,190 131,189 130,188 129,188 128,189 127,189
57,35 57,34 58,33 59,32 60,31 61,30 62,29 63,28 64,27 65,26 66,25 67,24 68,24 69,24 70,23 71,22 72,21 73,20 74,19 75,18 76,17 77,16 78,15 79,14 80,13 81,12 82,11 83,10 84,10 85,11 86,12
67,201 68,200 69,199 70,198 71,199 72,200 73,201 74,201 75,200 76,199 77,199 78,198 79,198 80,197 81,196 82,195 83,194 84,193 85,192 86,191 87,190 88,189 89,189 90,190 91,191 92,192 93,193 94,194 95,195 96,196
172,110 171,109 170,108 169,107 168,106 167,105 166,104 165,103 164,102 163,101 162,100 161,99 160,98 159,97 159,96 158,95 157,94 156,93 155,92 154,91 153,90 152,89 151,88
6,229 7,228 8,227 9,226 10,225 11,224 12,223 13,223 14,222 15,221 16,220 17,220 18,221 19,222 20,223 21,224 22,225 23,226 24,227 25,228 26,228 27,228 28,229 29,230 30,231 31,232 32,233
169,159 170,158 171,157 172,156 173,157 174,158 175,159 176,160 177,161 178,162 179,163 180,164 181,165 182,166 183,167 184,168 185,169 186,170 187,171 188,172 189,173 190,174 191,175 192,176 193,177 194,178 195,179
182,191 183,192 183,193 184,194 185,195 186,196 187,197 188,198 189,199 190,200 191,201 192,202 192,203 192,204 191,205 190,206 189,207 188,208 187,209 186,209 185,208 184,207 183,206 182,205 181,204 180,203 179,203 178,204 177,205 176,206 175,207 174,208 173,209 172,210 171,211 170,211 169,212 168,213 167,213 166,213 165,212 164,211 163,210 162,211 161,212 160,213 159,214 158,215 157,216
219,108 220,107 221,106 222,105 223,104 224,103 225,102 226,101 227,100 228,99 229,98 230,98 231,99 232,100
78,39 77,38 76,37 75,36 74,35 73,35 72,34 71,33 70,32 69,31 69,30 68,29 67,28 66,27 65,26 64,25 63,24 62,23 61,22 60,21 59,20 58,19 57,18 56,17 55,16 54,15 53,14 53,13
19,20 20,19 21,19 22,20 23,21 24,22 25,23 26,24 27,25 28,26 29,26 30,27 31,28 32,29 33,30 34,31 35,32 35,33 36,34 37,35 38,36 38,37 39,38 40,39 41,40 41,41 42,42 43,43 44,43 45,43 46,43 47,43 48,42 48,41 48,40 48,39 47,38 48,37 49,36
26,89 27,88 28,88 29,87 30,86 31,85 32,86 33,87 34,87 35,88 36,89 37,90 38,91 39,90 40,90 41,91 42,90 43,89 44,88 45,87 46,86 47,86
2,172 1,171 0,170 0,169 0,168 0,167 0,166 0,165 0,164 0,163 0,162 0,161 0,160 0,159 0,158 0,157 0,156 0,155 0,154 0,153 0,152 0,151 0,150 0,149 0,148 0,147 0,146 0,145 0,144 0,143 1,142
62,14 61,14 60,15 59,16 58,17 57,18 56,19 56,20 57,21 58,22 59,23 60,24
27,134 26,133 25,132 24,131 23,130 22,129 21,129 20,130 19,131 18,130 17,130 16,130 15,129 14,128 13,127 12,126 11,125 10,124 9,123 9,122 10,121 11,120 12,119
1,123 0,122 0,121 0,120 0,119 0,118 0,117 0,116 0,115 0,114 0,113 0,112 0,111 0,110
243,10 242,10 241,10 240,11 239,12 238,13 238,14 237,15 236,16 235,17 234,18 233,19 232,20 231,21 230,22 229,23 228,24 228,25 228,26 228,27 227,28 228,29 227,30 226,31 225,32 224,32 223,33 222,34 221,35 220,36 219,37 218,38
201,105 200,104 199,103 198,102 197,101 196,100 195,99 194,99 193,98 192,97 191,96 190,95 189,94 188,93 187,92 186,92
103,218 102,217 101,216 100,217 99,218 98,219 97,220 96,220 95,220 94,220 93,221 92,222 91,223 90,224 89,225 88,226 87,227 86,228 85,229 84,230 83,231 82,232 82,233 83,234 84,234 85,234
109,70 108,69 107,68 106,67 105,66 104,65 103,64 102,63 101,62 101,61 102,60 103,59 104,58 105,57 106,56 106,55 107,54
114,59 114,58 115,57 116,56 117,55 118,54 119,53 120,52 121,51 122,50 123,49 123,48 124,47 125,46 126,45 127,44 128,43 129,42 130,42
221,177 220,176 219,175 218,174 217,173 216,173 215,174 214,174 213,174 212,173 211,173 210,174 209,175 208,176 207,177 206,178 205,179 204,180 203,181 202,181 201,182 200,183 199,184 198,185 197,186 196,187 195,188 194,188 193,188 192,189 191,190
54,4 55,3 56,2 57,3 58,4 59,5 60,6 60,7 59,8 58,9 57,10 56,11 55,12 54,13 53,14 52,15 52,16 51,17 51,18 52,19 53,20 54,21
159,40 160,39 161,38 162,37 163,36 164,35 165,36 166,37 167,38 168,39 169,39 170,39 171,39 172,40 173,41 174,42 175,43 176,44 177,45 178,46 179,47 180,48 181,49 182,50 183,51 184,52 184,53 184,54 184,55 185,56 186,57 187,58
176,223 177,224 178,224 179,223 180,222 181,221 182,220 183,219 184,218 185,217 186,216 187,215 188,214 189,215
137,3 137,4 138,5 139,6 140,7 141,8 142,9 143,10 144,11 145,12 146,13 147,14 148,15 149,16 150,17 151,17 152,17 153,18 154,17 155,18 156,18 157,19
236,224 235,225 234,226 233,227 233,228 234,229 235,230 236,231 237,232 238,233 239,234 240,235 241,236 242,237 243,238 244,239 245,240 246,241 247,242 248,243 248,244 249,245 249,246
200,14 199,15 199,16 198,17 197,18 198,19 198,20 198,21 197,22 196,23 196,24 197,25 198,26 199,27 199,28 200,29 200,30 201,31 202,32 203,33 203,34 203,35 204,36 205,37
115,164 116,163 117,162 118,161 119,160 120,161 121,162 122,163 123,164 124,165 125,166 126,167 127,168 128,168 129,169 130,169 131,170 132,170 133,169 134,168 135,168 136,168 137,168 138,168 139,169 140,170 141,171 142,172
194,240 193,239 192,238 191,237 190,236 191,235 191,234 191,233 191,232 190,231 189,230 188,229 187,228 186,227 185,228 184,229 183,230 182,231 181,232 180,233 179,234 178,235
72,25 71,24 70,23 70,22 70,21 70,20 69,19 68,18 67,17 66,16 65,15 64,14 63,13 62,12 61,11 61,10 60,9 59,8 60,7 60,6 59,5 58,4 57,3 57,2 58,1
23,121 22,120 21,119 20,118 20,117 19,116 19,115 19,114 19,113 19,112 19,111 19,110 19,109 19,108 18,107
145,240 144,239 145,238 146,237 147,236 148,235 148,234 148,233 147,232 147,231 146,230
202,76 201,76 200,77 199,78 198,79 197,80 196,81 195,82 194,83 193,84 192,85 191,86 191,87 190,88 189,88 188,89 187,90 186,91
138,51 138,52 139,53 140,54 141,55 142,56 143,57 144,56 145,55 146,55 147,56 148,57 149,58 150,59 151,60 152,60 153,60 154,59 155,60
166,141 167,141 168,142 169,143 170,144 171,145 172,146 173,147 174,148 175,149 176,150 177,151 178,152 179,153 180,154 181,155 182,156 183,157 184,158 185,159 186,160 187,161 188,162 189,163 190,164 191,165 192,166 193,167 194,168 195,169
245,122 244,121 243,120 242,119 242,118 242,117 241,116 240,115 239,114 238,113 237,112 236,112 235,111 234,110 233,109 232,108 231,107 230,106 229,106 228,106 227,106 226,105 225,104 224,105
33,227 32,226 33,225 34,224 35,223 36,222 37,221 38,220 39,219 40,218 41,217 42,216 43,215 44,214 45,215 46,216 47,217 48,218 49,219 50,219 51,220 52,220 53,220 54,220 55,221 56,222 57,223 58,224
134,108 133,107 132,106 131,105 130,104 129,103 128,102 127,101 126,100 125,99 124,98 125,97 126,96 127,95 128,94 129,93 130,92 131,91 130,90 129,89 128,88 127,87 126,86 125,85 124,86 123,87 122,86 121,85 120,84 119,83 118,82 117,81 116,80 115,79 114,78 113,77 112,77 111,76 110,76 109,77 108,78
178,6 177,5 176,5 175,5 174,4 173,3 172,2 171,1 170,1 169,2 168,3 167,4 166,5 165,6
101,10 100,9 99,9 98,10 97,11 96,12 95,13 94,14
212,243 213,244 214,245 215,246 216,247 217,248 218,249 219,249 220,249 221,248 222,248 223,247 224,248 225,248 226,247 227,246 228,245 229,244 230,244 231,245 232,246 233,247 234,248
66,223 67,222 68,221 69,220 70,219 71,218 72,217 73,216 74,215 75,215 76,216 77,217 78,218 79,219 80,220 81,221 82,222 83,222 84,222 85,221 86,220 87,220
173,205 174,204 175,203 176,202 177,201 178,201 179,202 180,203 181,204 182,205 183,206 184,207 185,208 186,209 187,209 188,208 189,207 190,206 191,205 192,204 192,203 192,202 191,201 190,200 189,199 188,198 187,197 186,196 185,195 184,194 183,193 182,193 181,192 180,191 179,190 178,189 177,188 176,187
241,157 240,156 239,156 238,155 237,154 236,154 235,153 234,153 233,153 232,152 231,151 230,150 229,149 228,148 227,147 226,146 225,145 224,144 223,143 222,142 221,141 220,140 219,139 219,138 219,137 218,136 217,135 216,134 215,133 214,132 213,131 212,131
49,48 50,49 51,49 52,48 53,47 54,46 55,45 56,45 57,45 58,46 59,47 60,48 61,49 62,50 63,51 64,52 65,53 66,54 67,55 68,56 69,57 70,58 71,59 72,60 73,60 74,61 75,62 76,63 77,64
100,131 99,130 98,129 97,128 96,128 95,127 94,126 93,126 92,127 91,128 90,129 89,130 88,131 87,132 86,131 85,130 84,129 83,128 82,127 81,126 80,125 79,124 78,123 78,122 77,121 76,120 75,119 74,118 74,117 75,116 76,115 77,114
138,152 137,151 136,150 135,149 135,148 135,147 135,146 136,145 136,144 135,143 134,142 133,141 132,140 131,139 130,138 129,137 128,136 127,135 126,134 125,133 124,132 123,133 122,134 121,135 120,136 119,137 118,137 117,138 116,139 115,140 114,141
30,44 29,43 28,42 27,41 26,40 25,40 24,41 23,41 22,41 21,40 20,39 19,40 18,41 17,41 16,42
45,110 44,109 43,108 43,107 44,106 45,105 45,104 46,103 46,102 45,101 46,100 47,99 48,98
166,178 167,177 168,176 169,175 170,174 171,173 172,173 173,173 174,173 175,173 176,173 177,172 177,171 176,170 175,169 174,168 173,167 172,166 171,165 170,164 170,163 170,162 170,161 170,160 171,159 172,158 173,157 174,156 175,155 176,154 177,153