26,11 25,12 24,13 23,14 22,15 21,16 21,17 22,18 23,19 24,20 25,21 26,22 27,23 28,24
4,20 3,19 2,18 1,17 0,16 0,15 1,14 2,13 3,12 4,11 4,10 5,9 6,8 7,7 8,6 9,5 10,4 11,3 12,2 13,3 14,4 15,5 16,6 17,7 18,8 19,9
9,5 8,6 7,7 6,8 5,9 4,10 4,11 3,12 4,13 5,14 6,15 6,16 7,17 8,18 9,19 10,19 11,20 12,20 13,21 14,22 15,23 16,24
14,12 15,11 16,10 17,9 18,8 19,7 20,7 21,8 22,9 23,10 24,11 25,12 26,13 27,14 28,15
17,25 16,24 15,23 14,22 13,21 12,20 11,20 10,19 9,19 8,18 7,17 6,16 6,15 5,14 4,13 3,12 2,11 3,10 4,9 5,8 6,7 7,6 8,5 9,4 10,3 11,2 12,1 13,0 14,0 15,0 16,0
4,29 3,29 2,29 1,28 0,27 0,26 0,25 0,24 0,23 0,22 0,21 0,20 0,19 0,18 0,17 0,16 0,15 0,14 0,13 0,12 0,11 0,10 0,9 0,8 0,7 1,6
25,4 24,5 23,6 22,7 21,8 20,9 19,10 18,11 17,12 16,13 17,14 18,15 19,16 20,17 21,18 22,19 23,20 24,21 24,22 23,23 23,24 24,25 25,26 26,27 27,28 28,29
13,29 12,28 13,27 14,26 15,25 16,24 17,24 18,24 19,24 20,25 21,25 22,24 23,23 24,22 24,21 23,20 22,19 23,18 24,17 25,16 26,15 27,14
19,0 18,0 17,0 16,0 15,0 14,0 13,0 12,0 11,0 10,0 9,0 8,0 7,0 6,0 5,0 4,0 3,0 2,0 1,1 0,2
22,9 21,10 20,11 19,12 18,13 17,14 18,15 19,16 20,17 21,18 22,19 23,20 24,21 24,22 23,23 22,24 21,25 20,25 19,24 18,24 17,24 16,23 15,22 14,21 13,22 12,23 11,24 10,25 9,26 8,27 7,28 6,29