0,5 0,4 0,3 0,2 0,1 1,0 2,0 3,0 4,0 5,0 6,0 7,1 6,2 5,3 5,4 5,5 5,6 4,7 3,7 2,7 1,7 0,6
23,2 22,1 23,0 24,0 25,0 26,0 27,0 28,1 27,2 26,3 25,4 24,3
25,15 25,14 25,13 26,12 26,11 26,10 27,9 27,8 28,7 29,8 29,9 29,10 29,11 29,12 29,13 29,14 29,15 29,16 29,17 29,18 29,19 29,20 28,21 27,20 26,19 26,18 25,17 25,16
9,23 8,24 7,24 6,25 5,26 5,27 5,28 6,29 7,29 8,29 9,29 10,28 11,27 12,26 13,26 14,25 14,24 15,23 15,22 15,21 14,20 13,19 12,19 11,20 10,21 9,22
3,12 4,11 5,11 6,12 5,13 4,13
14,28 15,27 16,27 17,27 18,27 19,27 20,27 21,27 22,28 21,29 20,29 19,29 18,29 17,29 16,29 15,29
14,10 15,9 16,9 17,9 18,9 19,10 19,11 20,11 21,12 20,13 19,14 18,14 17,14 16,13 15,12 15,11
0,20 0,19 0,18 1,17 2,17 3,17 4,18 4,19 4,20 3,21 2,22 1,21
20,14 21,13 22,14 21,15
5,11 6,10 7,11 6,12