10,10 10,9 10,8 11,7 12,7 13,7 14,8 15,8 16,8 17,7 18,6 19,5 20,5 21,5 22,6 22,7 22,8 21,9 20,9 19,10 18,10 17,11 16,12 15,13 14,13 13,13 12,14 11,13 11,12 10,11
2,6 2,7 3,8 4,9 5,9 6,9 7,8 8,7 7,6 7,5 6,4 5,3 4,4 3,5
16,27 15,27 14,27 13,26 13,25 14,24 14,23 15,22 16,21 17,21 18,21 19,22 20,22 21,23 22,24 23,24 24,25 25,24 26,25 27,24 27,23 27,22 27,21 26,20 26,19 27,18 28,17 29,18 29,19 29,20 29,21 29,22 29,23 29,24 29,25 29,26 29,27 29,28 28,29 27,29 26,29 25,29 24,29 23,29 22,29 21,29 20,29 19,29 18,28 17,28
0,19 1,18 2,19 1,20
22,23 23,22 24,23 23,24
22,15 23,14 24,15 23,16
6,18 6,17 7,16 8,16 9,15 10,15 11,16 12,17 12,18 11,19 10,20 9,20 8,20 7,19
16,14 17,13 18,14 17,15
26,6 26,5 27,4 28,4 29,5 29,6 29,7 28,8 27,8 26,7
24,15 25,14 26,15 25,16